1111111111111111111111111111
1000E00010000000000000000001
1010010100100000101001000001
1010010000101010001001000001
100P0000100000000C0000000001
1111111111111111111111111111